#######
# @ # #
# $   #
#     #
#    .#
#######